00000000000000000000
0..................0
000..............000
0000.....00.....0000
0..................0
0....00......00....0
0...000000000000...0
0..................0
000..............000
0..00..........00..0
0..................0
0......000000......0
0..................0
000000........000000
000................0
00000000000000000000